###############
#-----#-----#-#
#-###-#-#####-#
E---#---------#
#-#-#####-#####
#-#-----#---#-#
#-###-#-###-#-#
#---#-#-------#
###-#-#########
#---#----#----#
#-#--#####-##-#
#-##---#---##-#
#-#--#-#-##-#-#
#-#-##------#-S
###############