000000000000000
011111011111010
010001010000010
E11101111111110
010100000100000
010111110111010
010001010001010
011101011111110
000101000000000
011101111011110
010110000010010
010011101110010
010110101001010
01010011111101S
000000000000000